1111111111111
10010000001C1
      0000001
1P0011E000001
1111111111111
